16 7
################
#          ##  #
###   ##   ##  #
#              #
#  #   #    ####
#  #   ###     #
################
