16 7
################
#              #
###   ##       #
#     ##       #
#  #        ####
#  #           #
################
